L B B X S G L
L R G B L R L
L G L R G B L
L R B G L G L
L G R L B G L
X L N B L B L
L G B L B R L
X L R G B L X
L B G L G C L
L N X R B G L
L G L S N G L
L B S R G B L
L X Y B L R L
L B R G X B L
L N B L C R L
L R C N H X L
L B R G S R L
X L N C B R L
L X B R G B L
L B R N L S L
L Y G B C H L
X G B R R G L
X L Y H N B L
L R B S R G L
L N N N N N L
X X X G X X X
- - - - - - -
