0 0 0 0 Y 0 0
X X X X X X X
C B C B C C X
B C X B Y C C
X X X X X X B
C B B C C N B
X C X B X B H
C X C Y X B C
B C X X R C G
C H G Y N B X
X C N C B X C
N X B G Y C B
X C G S S B C
S B R N B G X
B G S B C X C
C G B S B C Y
X X X X X X G
N N N Y B C G
S S S C X B R
G B C G N B G
Y N N N B G X
C X X X X X X
B G N B Y B N
X X X X X X C
N G B G Y G B
X X X X X X X
- - - - - - -
