0 0 0 P 0 0 0
C X C X C X C
B C B H N B C
C B C X C B X
X C B C N C B
B B X N C B C
C H C B C C B
B B N B N H X
X X C C X B B
N B H C B X B
B N C B X B C
B H B C H C B
C B X N B B X
X B C C X C B
B C B N C H B
C B C B B C X
X B H C C B C
C N C B N C X
C X C X C X C
X C B C B C X
B B X B X B N
B C H C C B X
C B C B N C C
X C X C B H X
B X C B C N C
X X C C C X X
- - - - - - - 