0 0 0 P 0 0 0
B G R B R B B
G R B G G R R
R R G N B R G
N B R G R G R
G B R B N R R
B G G R B G N
G R B B R G B
B N R G R R G
R G G B R G B
B G R N G R R
G R B R B B G
N N R G B R B
R G B B R G G
B R G N G R N
R B G R G N R
G B R G R R B
R G B B R G B
N N R G B G G
R G B N G B R
G R N G B R B
R B R G B B G
N G B R R G B
G B R B N R G
N B N R G B G
X X X G X X X
- - - - - - -