X X X B X X X
B G R B R X B
B X N G B G R
R R G B X R B
N B R X R G B
B X R G B R G
G R B N G X R
B N G B X R G
X X R G B B R
R N G B R G G
X R G B N B X
X X R B R G N
G R B B G R B
R G X R B X R
N R B G X R G
B G R R G B R
G R B G R X R
B X N R G B R
X R B R N B R
B R G G R G N
X X R B N G B
B G R R G B R
G X N R B G B
N R G B G X G
X X X G X X X
- - - - - - -
