N N N N N N N
X X X X X X N
X N N N N N N
X N X X X X X
X N N N N N X
X X X X X N X
X N N N N N X
X N X X X X X
X N N N N N X
X X X X X N X
X N N N N N X
X N X X X X X
X N N N N N X
X X X X X N X
X N N N N N X
X N X X X X X
X N N N N N X
X X X X X N X
X N N N N N X
X N X X X X X
X N N N N N X
X X X X X N X
X N N N N N X
X N X X X X X
X N N N N N X
X X X X X X X
- - - - - - -
