B R G R X X R
B G X R G B R
N R G R G B X
X R G B R G N
B N R B R G B
G B R H G R G
B G N G R X X
X R G B G N R
B R R X R G B
R G B N G H R
B R G B R G R
X R X B G R B
G B R B N R B
R H G B G B G
G G R X R X G
N R G R G N G
B R H G R B R
B G B X R N G
B G N R B G X
G B G X R N G
H G B R G R R
G B X R B G B
B R N G R G G
B G R B H R N
X X X G X X X
- - - - - - -
