R B B X S G R
X R G B G R B
R G X R X X G
B X B G R G B
G G R X B G X
R B N B X B R
G H B X R R G
X X R G B X R
G B G X X C B
G N X R B G X
B G X S N G B
G B S R G B X
G X Y B X R B
B B R G X B N
G N B R C R B
B R C N H X C
G B R G S R X
N G N C B R G
X X B R G B G
G B R N S S S
Y G G B C H R
X X B R R G B
S S Y H N B G
G R B S R G R
N N N N N N N
X X X X X X X
- - - - - - -
