0 0 0 P 0 0 0
X S S S S S X
S X S X S X S
G R G S G R G
S S X R N G R
S S S N G R B
X X H G B S S
S R S G X S N
G S G S G R S
S G N R S G X
X S S H G S X
S X S X S X S
G S S N S G R
N G G S N S S
S S S S S S S
X X N X G R G
S S S S G H S
S R S S S N R
S S X X G R B
X R S S R S S
S G S B H S G
N R N S S G B
S S S G B R X
X B S R N G S
S S N R X S R
X X X S S S S
- - - - - - -   