0 0 0 P 0 0 0
R B B X R G R
X R G B G R B
R G X R X X G
B X B G R G B
G G R X B G X
R B N B X B R
G B B X R R G
X X R G B X R
G B G X X R B
G N X R B G X
B G X B N G G
X B R R G B X
G X G B X R B
B B R G X B N
G N B R G R B
X X X X X X X
- - - - - - -
